##########
#        #
#  ####  #
#  #1    #
#     #  #
##########
